UWM=nationwide/uwm/uwm.exe
PennyMac=nationwide/pennymac.exe
Flagstar=nationwide/flagstar.exe
Mega Capital=nationwide/megacapital/megacapital.exe
The Loan Store=nationwide/loanstore/loanstore.exe
Kind=nationwide/kind.exe
Freedom=nationwide/freedom.exe
Provident=nationwide/provident.exe
Orion=nationwide/orion.exe
Sierra Pacific=nationwide/sierra/sierra.exe
Nations Direct=nationwide/nationsdirect.exe
Plaza=nationwide/plaza.exe
Logan Finance = nationwide/logan_finance.exe
Home Bridge = nationwide/home_bridge.exe
EPMX = nationwide/epm.exe
JMAC = nationwide/jmac.exe
Emporium = nationwide/emporium.exe
Brokers ADV = nationwide/brokers_adv.exe
Angel Oak = nationwide/angel_oak.exe
FNBA = nationwide/fnba.exe
Dart Bank = nationwide/dart_bank.exe
Quontic = nationwide/quontic.exe
Resicentral = nationwide/resicentral.exe
AD Mortgage = nationwide/adMortgage.exe
Royal Business Bank = nationwide/royalbb.exe
Cake Mortgage = nationwide/cake_mortgage.exe
United AG = nationwide/unitedAg.exe
REMN Whole Sale = nationwide/remn.exe
The Lender = nationwide/thelender.exe
PRMG = nationwide/prmg.exe
NMSI = nationwide/nmsi.exe
Nex Bank = nationwide/nex_bank.exe
Sprint EQ = nationwide/springEq/springEq.exe
Windsor = nationwide/windsor.exe
Newfi = nationwide/newfi.exe
Mutual of Omaha = nationwide/mutual_of_omaha.exe
Gold Star Financial = nationwide/goldstar.exe
AM West Wholesale = nationwide/amwest_wholesale.exe
Home Express = nationwide/homexpress.exe
CMG = nationwide/cmg.exe
Jet Advantage Mortgage = nationwide/jet_advantage_mortgage.exe
Forward Lending = nationwide/forward_lending.exe
Bluepoint = nationwide/bluepoint/bluepoint.exe
LoanStream/OCMBC (2FA) = nationwide/loan_stream.exe
Change = nationwide/Change.exe
Champion = nationwide/champion/champion.exe
Home Bridge (HELOC) = nationwide/homebridge_heloc.exe
ACRA Lending = nationwide/acra.exe
Clear Edge Lending = nationwide/clear_edge.exe
AFR = nationwide/AFR.exe
NewRez = nationwide/newrez.exe